Girls – Father, Son, Holy GhostDrake – Take Care
Bon Iver – Bon Iver
Fucked Up – David Comes To Life
The Weeknd – House Of Balloons
Gang Gang Dance – Eye Contact
EMA – Past Life Martyred Saints
PJ Harvey – Let England Shake
ASAP Rocky – LIVELOVEA$AP
Kanye West & Jay-Z – Watch The Throne
Kate Bush – 50 Words For Snow
M83 – Hurry Up, We’re Dreaming
Yuck – Yuck
Austra – Feel It Break
Zola Jesus – Conatus
Neon Indian – Era Extraña
Oneohtrix Point Never – Replica
Beyoncé – 4
Iceage – New Brigade
Real Estate – Days
Clams Casino – Instrumental Mixtape
Ryan Adams – Ashes & Fire
Wild Flag – Wild Flag
Frank Ocean – Nostalgia, Ultra
Cold Cave – Cherish The Light Years
The Pains Of Being Pure At Heart – Belong
Destroyer – Kaputt
Pictureplane – Thee Physical
Washed Out – Within And Without
Radiohead – The King Of Limbs
Fleet Foxes – Helplessness Blues
St. Vincent – Strange Mercy
SBTRKT – SBTRKT
Kurt Vile – Smoke Ring For My Halo
Atlas Sound – Parallax
Cut Copy – Zonoscope
Smith Westerns – Dye It Blonde
Burst Apart – Burst Apart
Nicolas Jaar – Space Is Only Noise
Kendrick Lamar – Section.80
Das Racist – Relax
Unknown Mortal Orchestra – Unknown Mortal Orchestra
Twin Sister – In Heaven
James Blake – James Blake
Adele – 21
tUnE-yArDs – w h o k i l l
Wilco – The Whole Love
Oddisee – Rock Creek Park
Toro Y Moi – Underneath The Pine
Youth Lagoon – The Year Of Hibernation
